めいちょう	鳴潮	固有名詞	
めいちょう	Wuthering Waves	固有名詞	
わざうぇいぶ	Wuthering Waves	固有名詞	
あとひめいじんるいきじ	後悲鳴人類記事	固有名詞	
こうさくするほしむれ	交錯する星群れ	固有名詞	
ひめい	悲鳴	名詞	
はんきょう	反響	名詞	
そうせいちょう	走声蝶	名詞	
かいゆうぎょ	回遊魚	名詞	
おんがい	音骸	名詞	
えこー	音骸	名詞	
そのら	音場	名詞	
そのら	ソノラ	名詞	
かいしょくげんしょう	海蝕現象	名詞	
ゔぉいどすとーむ	ヴォイドストーム	名詞	
ぼいどすとーむ	ヴォイドストーム	名詞	
むおんく	無音区	名詞	
ざんぞうちょう	残像潮	名詞	
くろいし	黒石	名詞	
てんくうかい	天空海	名詞	
そかいあめ	溯洄雨	名詞	
はんきょうぐも	反響雲	名詞	
くろしお	黒潮	名詞	
うんかい	雲海	名詞	
すいふうきゅう	水風級	名詞	
きょろうきゅう	巨浪級	名詞	
どとうきゅう	怒涛級	名詞	
つなみきゅう	津波級	名詞	
うんりょうだに	雲陵谷	名詞	
わんとう	湾刀	名詞	
おんこう	音匣	名詞	
かぜやみのすず	風止みの鈴	名詞	
きょうめいしゃ	共鳴者	名詞	
でばいす	瓢箪	固有名詞	
おんこん	音痕	名詞	
おーばーくろっく	自滅	名詞	
そりゅうき	遡流器	名詞	
くろいしぶき	黒石武器	名詞	
ちょうじん	長刃	名詞	
じんとう	迅刀	名詞	
けんじゅう	拳銃	名詞	
てっこう	手甲	名詞	
ぞうふくき	増幅器	名詞	
しんい	辛夷	名詞	
ごひいきさま	御贔屓様	名詞	
しんごうとう	信号塔	名詞	
はんこ	盤古	名詞	
せっししょ	折子書	名詞	
こうらんるいしょ	瑝覧類書	固有名詞	
れいいん	令尹	固有名詞	
すいえいへい	水影塀	名詞	
てんこうへんきょうぼうえい	天工辺境防衛	固有名詞	
ずいしだん	瑞獅団	固有名詞	
こうりゅうだん	絞龍団	固有名詞	
しんげつこ	心月狐	固有名詞	
けいとかい	競渡会	固有名詞	
げっついさい	月追祭	固有名詞	
しゅんりゅうさい	春龍祭	固有名詞	
うんかいれっしゃ	雲海列車	固有名詞	
むごうりょうほう	霧合療法	固有名詞	
むごうやくざい	霧合薬剤	固有名詞	
しゅざ	主座	名詞	
しんけん	神権	名詞	
いけん	異権	名詞	
かんこんさい	還魂祭	固有名詞	
せんくらじお	先駆ラジオ	固有名詞	
そりゅうき	溯流器	名詞	
しゃだんこうまく	遮断光幕	名詞	
ちうがちのくさび	地穿ちの楔	固有名詞	
さとしのおんな	諭しの女	名詞	
くろしおぐも	黒潮雲	名詞	
なぽりにせいのらんたん	ナポリ2世のランタン	固有名詞	
あんかーすとーん	アンカーストーン	名詞	
わんとうのたたかい	湾刀の戦い	固有名詞	
うんりょうだにのたたかい	雲陵谷の戦い	固有名詞	
いしくずれのこうちのたたかい	石崩れの高地の戦い	固有名詞	
ほくらくのはらのたたかい	北落野原の戦い	固有名詞	
げっついさい	月追祭	固有名詞	
しゅんりゅうさい	春龍祭	固有名詞	
とびはんたー	飛びハンター	名詞	
おんがくのほたる	音楽の蛍	名詞	
てぃるふぉんぐ	ティルフォング	固有名詞	
おーとくれあ	オートクレア	固有名詞	
ふるんぐりえ	ブルングリエ	固有名詞	
ちょうせきのおくりもの	潮汐の贈物	名詞	
ちょうせきのぞうぶつ	潮汐の贈物	名詞	
ひぞうばこ	秘蔵箱	名詞	
いんかいきょうだん	隠海教団	組織	
ふらくとしです	残星組織	組織	
ぶらっくしょあ	黒海岸	組織	
ぶらっくしょあ	ブラックショア	組織	
よき	夜帰	組織	
よきぐん	夜帰軍	組織	
はじん	破陣	組織	
ふくは	伏波	組織	
とうはく	踏白	組織	
ちあんしょ	治安署	組織	
じゅんねいじょ	巡寧所	組織	
いしょういてんじょ	異象移転所	組織	
きゅうしんがっこう	旧神学校	組織	
ないしゃいん	内赦院	組織	
かいりついん	戒律院	組織	
ざんげいん	懺悔院	組織	
せんくじょうやく	先駆条約	組織	
ごーすとはうんど	幽霊猟犬	組織	
かそ	華胥	組織	
かそけんきゅういん	華胥研究院	組織	
ずいしだん	瑞獅団	組織	
こうりゅうだん	絞龍団	組織	
てんこう	天工	組織	
てんこうぶ	天工部	組織	
てんこうへんきょうぼうえい	天工辺境防衛	組織	
すたーとーちがくえん	スタートーチ学園	組織	
せんじゅつかいはつがっかぐん	戦術開発学科群	組織	
すぺーすとれっくこれくてぃぶ	スペーストレック・コレクティブ	組織	
すぺーすとれっくこれくてぃぶ	深宇宙連合	組織	
ぶらっくしょあしょとう	ブラックショア諸島	地名	
すぷらうつのち	スプラウツの地	地名	
ててぃすちゅうすうぶ	テティス中枢部	地名	
いてんいしょうじょ	移転異象所	地名	
えらーしゅうようじょ	エラー収容所	地名	
えねるぎーせんたー	エネルギーセンター	地名	
ててぃすのそこ	テティスの底	地名	
えいどすのかがみ	エイドスの鏡	地名	
ちょうりつほーる	調律ホール	地名	
せいめいのはこぶね	生命の箱舟	地名	
でーたのげきりゅう	データの激流	地名	
ときのすきまにすたれていくまち	時の隙間に廃れていく街	地名	
しゃしょうかふぇ	車掌カフェ	地名	
しあわせふんすいこうえん	しあわせ噴水公園	地名	
さざなみどおり	さざなみ通り	地名	
さざなみとおり	さざなみ通り	地名	
ほくらくのはら	北落野原	地名	
くうちゅうはいきょ	空中廃墟	地名	
しょくてい	稷廷	地名	
らっこうむら	落香村	地名	
かくしゅく	角宿	地名	
こうしゅく	亢宿	地名	
ていしゅく	氐宿	地名	
ぼうしゅく	房宿	地名	
しんしゅく	心宿	地名	
びしゅく	尾宿	地名	
きしゅく	箕宿	地名	
りゅうみんてい	龍眠庭	地名	
こうりゅう	瑝瓏	地名	
いっていろくしゅう	一庭六州	地名	
しょうしゅう	詔州	地名	
えっしゅう	越州	地名	
こうと	瑝都	地名	
むしゅう	夢州	地名	
こんしゅう	今州	地名	
いっていごしゅう	一庭五州	地名	
こんしゅうじょう	今州城	地名	
みずうみぞいのおか	湖沿いの丘	地名	
へいていざん	屏庭山	地名	
たきたれがわ	滝垂川	地名	
へんてい	辺庭	地名	
じょうしょうさん	乗霄山	地名	
さいこうはま	砕光浜	地名	
せいてんれい	星転嶺	地名	
こうちん	虹鎮	地名	
てんしゅぼく	天取木	地名	
りゅうせきのおね	龍脊の尾根	地名	
がりゅうのおか	臥竜の丘	地名	
りゅうまといのがけ	龍纏いの崖	地名	
れいさのいずみ	霊砂の泉	地名	
よしゅう	予洲	地名	
うんりょうだに	雲陵谷	地名	
よあけのさか	夜明けの坂	地名	
ぎょくりゅうだい	玉龍台	地名	
めいしょうたに	鳴鐘渓	地名	
かさねいしのへいち	重ね石の平地	地名	
とうげんきょう	桃源郷	地名	
たにほくぶ	谷北部	地名	
ぼうりゅうこう	望龍郊	地名	
さいかしょう	採華庄	地名	
ちゅうぶだいち	中部台地	地名	
きちむら	祈池村	地名	
しおおこしのがけ	潮起こしの崖	地名	
いしくずれのこうち	石崩れの高地	地名	
えんぼうのみね	遠望の嶺	地名	
さびれたぼうえいせん	寂れた防衛線	地名	
ふくはじんちまえ	伏波陣地前	地名	
しゅうせんのせき	終戦の関	地名	
ほくらくだに	北落谷	地名	
ここうさいくつじょう	虎口採掘場	地名	
くちたがくこく	朽ちた壑谷	地名	
げんげつしょう	弦月礁	地名	
ぶつりゅうせんたー	物流センター	地名	
きらいのみなと	帰来の港	地名	
えいはくかい	螢泊海	地名	
とうろくけんきゅうじょ	東麓研究所	地名	
ふんえんかい	焚焔海	地名	
らくちゃくみね	落着嶺	地名	
ひかりなきもり	光なき森	地名	
えんちがい	猿知崖	地名	
しげつのがじゅまる	紫月のガジュマル	地名	
いばらむれのほどう	茨群れの歩道	地名	
いしあらいのはら	石洗いの原	地名	
ちゅうぶがじゅまる	中部ガジュマル	地名	
ぶんやはま	聞野浜	地名	
ぶぶぶつりゅうそうこ	ブブ物流倉庫	地名	
えんちょうのぬま	怨鳥の沼	地名	
しょくていのいせき	稷廷の遺跡	地名	
さぎのしっち	鷺の湿地	地名	
りゅうざんのわたしば	龍山の渡し場	地名	
こんそうのみなと	鯀巣の港	地名	
ほなみし	穂波市	地名	
あしのはら	葦ノ原	地名	
ねぷてゅーにあ	海淵の星	地名	
らぐーなじょう	ラグーナ城	地名	
もんてりく	モンテリ区	地名	
ひろばく	広場区	地名	
ぎんこうどおり	銀行通り	地名	
ぎんこうとおり	銀行通り	地名	
そのかぜのへいぶん	そよ風のヘイヴン	地名	
そのかぜのへいゔん	そよ風のヘイヴン	地名	
ぽりゅぺーもんういんどみる	ポリュペーモス・ウインドミル	地名	
ぽりゅぺーもんうぃんどみる	ポリュペーモス・ウインドミル	地名	
みすとゔぇいるわん	ミストヴェイル湾	地名	
みすとべいるわん	ミストヴェイル湾	地名	
えぐら	エグラ	地名	
ぺにてんとのふきだまり	ペニテントの吹き溜まり	地名	
ふぃぎゅあへっどのさいしじょう	フィギュアヘッドの祭祀場	地名	
ぐしゃのらくえん	愚者の楽園	地名	
はろうどりーち	ハロウド・リーチ	地名	
れくいえむらゔぃーん	レクイエム・ラヴィーン	地名	
れくいえむらびーん	レクイエム・ラヴィーン	地名	
はろうどりーちのちか	ハロウド・リーチの地下	地名	
なげきのながはし	嘆きの長橋	地名	
かすみたつすいきょう	霞立つ水境	地名	
のくたーんがーでん	ノクターン・ガーデン	地名	
ごーるどずらんでぃんぐ	ゴールドズ・ランディング	地名	
ぶなはんとう	ブナ半島	地名	
おーくのにわ	オークの庭	地名	
おんちょうのかいがん	恩寵の海岸	地名	
らすとぶれすしょあ	ラストブレスショア	地名	
でぃされーかいれい	ディサレー海嶺	地名	
そーんくらうんたわー	ソーンクラウンタワー	地名	
ろすとぱらだいす	ロストパラダイス	地名	
ふたごのやま	双子の山	地名	
ぽるとゔぃーのじょう	ポルトヴィーノ城	地名	
ぽるとびーのじょう	ポルトヴィーノ城	地名	
べおかいいき	ベオ海域	地名	
あゔぃのれーむちかいせき	アヴィノレーム・地上遺跡	地名	
あびのれーむちかいせき	アヴィノレーム・地上遺跡	地名	
あゔぃのれーむ	アヴィノレーム	地名	
あびのれーむ	アヴィノレーム	地名	
しんぎのま	神儀の間	地名	
ほんとびらとしょかんいせき	本扉図書館・遺跡	地名	
せいげんのま	聖言の間	地名	
けんじゅほーるいせき	剣授ホール・遺跡	地名	
しょうかのとう	昇華の塔	地名	
ざくーんていえんいせき	ザクーン庭園・遺跡	地名	
つなぎのとう	繋ぎの塔	地名	
りじょりぐんとう	リジョリ群島	地名	
りじょりこう	リジョリ港	地名	
へるむむら	ヘルム村	地名	
せりーんわん	セリーン湾	地名	
れいえすいせき	レイエス遺跡	地名	
どらこしま	ドラコ島	地名	
どらこじま	ドラコ島	地名	
しろきつきのもりいせき	白き月の森遺跡	地名	
いんかいじっけんじょう	隠海実験場	地名	
むくろのしま	骸の島	地名	
せいめいのこうぼう	生命の工房	地名	
えなじーちゅうすう	エナジー中枢	地名	
さんくちゅあり	サンクチュアリ	地名	
あかりのこうとう	明りの高塔	地名	
そうしつのめいふ	喪失の冥府	地名	
せぶんひるず	セブン・ヒルズ	地名	
たいたんぼーんえくすばんす	タイタンボーン・エクスバンス	地名	
もーんふぇるきゃにおん	モーンフェル・キャニオン	地名	
みーのーすちかすいろ	ミーノース地下水路	地名	
もんてでりみと	モンテ・デリミト	地名	
ぐろーりあゔぇいる	グローリアヴェイル	地名	
ぐろーりあべいる	グローリアヴェイル	地名	
かんぴどーののおか	カンピドーノの丘	地名	
さんぐいすしゅりょうだいち	サングイス狩猟台地	地名	
あてぃりうすあいろ	アティリウス隘路	地名	
かりうどのきゃんぷ	狩人のキャンプ	地名	
てとらごんしんでん	テトラゴン真殿	地名	
らすとりっじ	ラストリッジ	地名	
うわごとのまち	うわごとの町	地名	
ちうがちのくさび	地穿ちの楔	地名	
ちょくしょくち	潮蝕地	地名	
まるーんうっどかりば	マルーンウッド狩り場	地名	
あすぽでろすのの	アスポデロスの野	地名	
もんてとらいひーろー	モンテ・トライヒーロー	地名	
ぱれーどぱらだいす	パレードパラダイス	地名	
あゔぇらるどきんこ	アヴェラルド金庫	固有名詞	
あべらるどきんこ	アヴェラルド金庫	固有名詞	
かんぴどーののしろ	カンピドーノの城	固有名詞	
ぎゃっきょうしんとう	逆境深塔	固有名詞	
ざんきょうのとう	残響の塔	固有名詞	
はんきょうのとう	反響の塔	固有名詞	
しんきょうのとう	深境の塔	固有名詞	
あんていえりあ	安定エリア	固有名詞	
じっけんえりあ	実験エリア	固有名詞	
きんいきえりあ	禁域エリア	固有名詞	
ほろたくてぃくす	ホロタクティクス	固有名詞	
しのうみがまとううみのはいきょ	死の歌が纏う海の廃墟	固有名詞	
きんきのかいいき	禁忌の海域	固有名詞	
さいせいのかいいき	再生の海域	固有名詞	
さいせいのかいいききゃずむ	再生の海域・キャズム	固有名詞	
さいせいのかいいきあびす	再生の海域・アビス	固有名詞	
えんどれすあびす	エンドレス・アビス	固有名詞	
せんのとびらのきそう	千の扉の奇想	固有名詞	
きゃずむ	再生の海域・キャズム	短縮よみ	
あびす	再生の海域・アビス	短縮よみ	
あびす	エンドレス・アビス	短縮よみ	
はいきょ	死の歌が纏う海の廃墟	短縮よみ	
きょうめいすきる	共鳴スキル	名詞	
きょうめいかいほう	共鳴解放	名詞	
きょうめいえねるぎー	共鳴エネルギー	名詞	
きょうめいかいろ	共鳴回路	名詞	
しゅうそう	終奏	名詞	
へんそう	変奏	名詞	
しゅうそうすきる	終奏スキル	名詞	
へんそうすきる	変奏スキル	名詞	
きょうそうえねるぎー	協奏エネルギー	名詞	
きょうどうこうげき	共同攻撃	名詞	
いじょうこうか	異常効果	名詞	
けっそう	結霜	名詞	
けっそうこうか	結霜効果	名詞	
せいばく	斉爆	名詞	
さいばくこうか	斉爆効果	名詞	
でんじこうか	電磁効果	名詞	
ふうしょく	風蝕	名詞	
ふうしょくこうか	風蝕効果	名詞	
そうこう	騒光	名詞	
そうこうこうか	騒光効果	名詞	
きょめつ	虚滅	名詞	
きょめつこうか	虚滅効果	名詞	
きょうしんど	共振度	名詞	
えこーせっと	音骸セット	名詞	
はーもにーこうか	ハーモニー効果	名詞	
ちょうせきにんむ	潮汐任務	名詞	
どうひょうにんむ	道標任務	名詞	
みちしるべにんむ	道標任務	名詞	
れんせいにんむ	連星任務	名詞	
きちにんむ	危地任務	名詞	
にちじょうにんむ	日常任務	名詞	
いつわにんむ	逸話任務	名詞	
しゅうきちょうせん	周期挑戦	名詞	
かそうくんれん	仮想訓練	名詞	
ぎょうそりょういき	凝素領域	名詞	
きょうてきとうばつ	強敵討伐	名詞	
せんかふくしょう	戦歌復唱	名詞	
むおんそうとう	無音掃討	名詞	
きょうめいちぇーん	共鳴チェーン	名詞	
せいせい	星声	名詞	
げっそう	月相	名詞	
しぇるこいん	シェルコイン	名詞	
けっしょうはちょうばん	結晶波長板	名詞	
けっしょうはちょうせいれんばん	結晶波長精錬板	名詞	
しょうかんのなみもよう	唱喚の渦模様	名詞	
きんずいのなみもよう	金髄の波模様	名詞	
たんちょうのなみもよう	鍛潮の波模様	名詞	
よはさんご	余波珊瑚	名詞	
ざんしんさんご	残振珊瑚	名詞	
ひぞうたんちき	秘蔵探知機	名詞	
たんおんそなー	探音ソナー	名詞	
かいしょくきめら	海蝕キメラ	名詞	
ちんたいきんぞくどろっぷ	沈滞金属ドロップ	名詞	
かっせいきんぞくぶろっぷ	活性金属ドロップ	名詞	
きょくかきんぞくどろっぷ	極化金属ドロップ	名詞	
いたいきんぞくどろっぷ	異体金属ドロップ	名詞	
きんぞくどろっぷ	金属ドロップ	名詞	
ふじゅんけっしょうねんそ	不純結晶燃素	名詞	
そひんけっしょうねんそ	粗品結晶燃素	名詞	
せいれんけっしょうねんそ	精錬結晶燃素	名詞	
じゅんすいけっしょうねんそ	純粋結晶燃素	名詞	
けっしょうねんそ	結晶燃素	名詞	
せいりつのたね	声律の種	名詞	
せいりつのなえ	声律の苗	名詞	
せいりつのは	声律の葉	名詞	
せいりつのつぼみ	声律の蕾	名詞	
せいりつ	声律	名詞	
ぷれすとらせん	プレスト螺旋	名詞	
あんだんてらせん	アンダンテ螺旋	名詞	
あだーじょらせん	アダージョ螺旋	名詞	
れんとらせん	レント螺旋	名詞	
うなりおんかく	唸り音核	名詞	
さけびおんかく	叫び音核	名詞	
らせんおんかく	螺旋音核	名詞	
しんしょくせいる	侵食セイル	名詞	
あやめ	鳶尾花	名詞	
ちゆうきんれん	黒野荒蓮	名詞	
ぶどうほおずき	灯籠菓	名詞	
おおごちょう	金陽鳳	名詞	
ぐびじん	妙姿花	名詞	
かわらたけ	雲芝	名詞	
やぐるまぎく	傲寒鐘	名詞	
むらさきさんご	紫珊瑚	名詞	
げんぺいくさぎ	ゲンペイクサギ	名詞	
えんじゃくか	燕雀菓	名詞	
かくせい	客星	名詞	
そーどあこーらす	ソードアコーラス	名詞	
ごーるでんふりーす	ゴールデンフリース	名詞	
すぱーくじゅえるうーど	スパークジュエルウード	名詞	
しぇんどれりす	ツェンドレリス	名詞	
ばんぶーあいりす	バンブー・アイリス	名詞	
びばーなむてぃぬす	ビバーナムティヌス	名詞	
はんきょうのしゅはたい	反響の周波帯	名詞	
すたーきゃりぶれーたー	スターキャリブレーター	固有名詞	武器/モーニエ
くもきり	曇斬	固有名詞	武器/千咲
らいていをすべしおうけん	雷霆を統べし王剣	固有名詞	武器/オーガスタ
とうえんのつめあと	闘炎の爪痕	固有名詞	武器/ルパ
さいかちょうわ	歳華調和	固有名詞	武器/今令尹
そうりんれんぽう	蒼鱗連峰	固有名詞	武器/忌炎
らでぃあんすのきっさき	ラディアンスの切っ先	固有名詞	武器/恒常☆5長刃(シンビオーシス武装)
せんきょうのここう	仙境の湖光	固有名詞	武器/恒常☆5長刃
かんじょのたえいすへあうとん	寛恕のタ・エイス・ヘアウトン	固有名詞	武器/☆4長刃/製造
ばんぶつをかきとめるげっそう	万物を書き留める月相	固有名詞	武器/ユーノ
えんこうのさばき	焔光の裁き	固有名詞	武器/ザンニー
とらじこめーでぃあ	トラジコメーディア	固有名詞	武器/ロココ
ばんたんのすうき	万端の枢機	固有名詞	武器/相里要
ぱるすのきわん	パルスの機腕	固有名詞	武器/恒常☆5手甲(シンビオーシス武装)
どとうのこおん	怒涛の湖音	固有名詞	武器/恒常☆5手甲
めいていのえぽす	酩酊のエポス	固有名詞	武器/☆4手甲/製造
ゆうめいのぼうゆうきょく	幽冥の忘憂曲	固有名詞	武器/フローヴァ
しんかいのささやき	深海の囁き	固有名詞	武器/カンタレラ
ひかりのはるもにあ	光のハルモニア	固有名詞	武器/フィービー
ほしぼしのこんちぇると	星々のコンチェルト	固有名詞	武器/ショアキーパー
ひょうかのがいん	氷華の雅印	固有名詞	武器/折枝
いとくりのきじゅつ	糸繰りの奇術	固有名詞	武器/吟霖
ぼぞんのかんそくき	ボゾンの観測器	固有名詞	武器/恒常☆5増幅器(シンビオーシス武装)
えいこのこがん	栄枯の湖岸	固有名詞	武器/恒常☆5増幅器
きみょうばりえーしょん	奇妙バリエーション	固有名詞	武器/☆4増幅器/集音
きょしょくのわるつ	虚飾のワルツ	固有名詞	武器/☆4増幅器/製造
すぺくとるぶらすたー	スペクトル・ブラスター	固有名詞	武器/リンネー
るくすあんどあんぶら	ルクス&アンブラ	固有名詞	武器/ガルブレーナ
もりのありあ	森のアリア	固有名詞	武器/シャコンヌ
らすとだんす	ラストダンス	固有名詞	武器/カルロッタ
ふぇーずのさざなみ	フェーズのさざ波	固有名詞	武器/恒常☆5拳銃(シンビオーシス武装)
ふへんのこえん	不変の湖煙	固有名詞	武器/恒常☆5拳銃
わかれのめろす	別れのメロス	固有名詞	武器/☆4拳銃/製造
はてきのえいちく	破敵の鋭竹	固有名詞	武器/仇遠
さだめをくつがえすけいかん	定めを覆す荊冠	固有名詞	武器/カルテジア
ちのめいやく	血の盟約	固有名詞	武器/漂泊者気道
えんどれすぼやーじゅ	エンドレスボヤージュ	固有名詞	武器/ブラント
はるたち	春裁ち	固有名詞	武器/ツバキ
あかくもゆるりゅうこう	赫く燃ゆる流光	固有名詞	武器/長離
れーざーのえいけん	レーザーの鋭剣	固有名詞	武器/恒常☆5迅刀(シンビオーシス武装)
せんこのこすい	千古の湖水	固有名詞	武器/恒常☆5迅刀
こうしんおーばーちゅあ	行進オーバーチュア	固有名詞	武器/☆4迅刀/集音
ふうしのふぁぶりおー	風刺のファブリオー	固有名詞	武器/☆4迅刀/製造
めいしょうのかめ	鳴鐘の亀	人名	残像/津波級
すかー	スカー	人名	残像/津波級
むぼうしゃ	無妄者	人名	残像/津波級
へかてー	ヘカテー	人名	残像/津波級
らいせつのうろこ	雷刹のウロコ	人名	残像/怒涛級
りょうげんのえんき	燎原の炎騎	人名	残像/怒涛級
むじょうのさぎ	無情のサギ	人名	残像/怒涛級
かがやきほたるのぐんぜい	輝き蛍の軍勢	人名	残像/怒涛級
ひれんのおおざる	飛廉の大猿	人名	残像/怒涛級
あいせつのきょうちょう	哀切の凶鳥	人名	残像/怒涛級
むかんしゃ	無冠者	人名	残像/怒涛級
きかいあぼみねーしょん	機械アボミネーション	人名	残像/怒涛級
うんせんのうろこ	雲閃のウロコ	人名	残像/怒涛級
ふぇいたるえらー	フェイタルエラー	人名	残像/怒涛級
ろーれらい	ローレライ	人名	残像/怒涛級
ぜのころっさす	ゼノコロッサス	人名	残像/怒涛級
なげきどれいく	嘆きのドレイク	人名	残像/怒涛級
ほまれのらいおねす	誉れのライオネス	人名	残像/怒涛級
けるぴー	ケルピー	人名	残像/怒涛級
けるぴー	ナイトメア・ケルピー	人名	残像/怒涛級
ないとめあけるぴー	ナイトメア・ケルピー	人名	残像/怒涛級
うみのむすめ	海の娘	人名	残像/怒涛級
うみのこ	海の娘	人名	残像/怒涛級
いつわりのしんおう	偽りの神王	人名	残像/怒涛級
こうとうじゅう	光踏獣	人名	残像/巨浪級
くらとすくす	クラトスクス	人名	残像/巨浪級
ころさうるす	コロサウルス	人名	残像/巨浪級
じんやてんけいのしょう	燼夜天啓の章	名詞	戦歌復唱/レビヤタン
きりとられたうんめいのわ	切り取られた運命の輪	名詞	戦歌復唱/響き渡る共鳴・フルールドリス
めいふのくりむそんのしゅうまく	冥府のクリムソンの終幕	名詞	戦歌復唱/ヘカテー
ときにさだめられしとうそう	時に定められし闘争	名詞	戦歌復唱/角
むかんきょぞうのこころ	無冠巨像の心	名詞	戦歌復唱/無妄者
むちつじょなへんきょうのひ	無秩序な辺境の火	名詞	戦歌復唱/スカー
かこからひびくしょうおん	過去から響く鐘音	名詞	戦歌復唱/鳴鐘の亀
ひびきわたるきょうめいふるーるどりす	響き渡る共鳴・フルールドリス	人名	音骸
ひびきわたるきょうめいめいしきれびやたん	響き渡る共鳴・鳴式・レビヤタン	人名	音骸
ふるーるどりす	響き渡る共鳴・フルールドリス	人名	音骸
れびやたん	響き渡る共鳴・鳴式・レビヤタン	人名	音骸
よるにこびりつくしらしも	夜にこびり付く白霜	名詞	
やまをとどろかせるほうか	山を轟かせる崩火	名詞	
そらをきりさくめいらい	空を切り裂く冥雷	名詞	
たにをつきぬけるちょうふう	谷を突き抜ける長風	名詞	
やみをとりはらううきほし	闇を取り払う浮星	名詞	
やみをとりはらううふせい	闇を取り払う浮星	名詞	
にどとかがやかないちんじつ	二度と輝かない沈日	名詞	
けんそうにかくすかいこう	喧騒に隠す回光	名詞	
つきをうかがうけいうん	月を窺う軽雲	名詞	
たえないよいん	絶えない余韻	名詞	
ふろすてっどはーと	フロステッド・ハート	名詞	
みっどないとべーる	ミッドナイト・ベール	名詞	
えたーなるらいと	エターナル・ライト	名詞	
たいずたーにんぐゔぁら	タイズターニング・ヴァラ	名詞	
たいずたーにんぐばら	タイズターニング・ヴァラ	名詞	
せれっしゃるあんさむ	セレッシャル・アンサム	名詞	
ばうんどれすすかい	バウンドレス・スカイ	名詞	
ぐろりあすうぃんど	グロリアス・ウィンド	名詞	
ぐろりあすういんど	グロリアス・ウィンド	名詞	
はうりんぐふれいむ	ハウリング・フレイム	名詞	
ろすとどりーむ	ロスト・ドリーム	名詞	
ぐろーりーふぉーじくらうん	グローリーフォージ・クラウン	名詞	
えーてるれぞなんす	エーテル・レゾナンス	名詞	
いんふぇるのしゃどう	インフェルノ・シャドウ	名詞	
めいりほうかいのげん	命理崩壊の弦	名詞	
たんきん	丹瑾	人名	
たおき	桃祈	人名	
やんやん	秧秧	人名	
かんしん	鑑心	人名	
えんぶ	淵武	人名	
しか	熾霞	人名	
びゃくし	白芷	人名	
さんか	散華	人名	
りんよう	凌陽	人名	
きえん	忌炎	人名	
いんりん	吟霖	人名	
こんし	今汐	人名	
ちょうり	長離	人名	
おりえ	折枝	人名	
そうりよう	相里要	人名	
そゆご	釉瑚	人名	
とうとう	灯灯	人名	
ゔぇりーな	ヴェリーナ	人名	
べりーな	ヴェリーナ	人名	
あーると	アールト	人名	
かかろ	カカロ	人名	
もるとふぃー	モルトフィー	人名	
あんこ	アンコ	人名	
しょあきーぱー	ショアキーパー	人名	
つばき	ツバキ	人名	
かるろった	カルロッタ	名	
かるろったもんてり	カルロッタ・モンテリ	人名	フルネーム/カルロッタ
ろここ	ロココ	人名	
ふぃーびー	フィービー	人名	
ぶらんと	ブラント	人名	
たーんぶらんと	ターン・ブラント	人名	ブラント/フルネーム
かんたれら	カンタレラ	名	
かるたれらふぃさりあ	カンタレラ・フィサリア	人名	カンタレラ/フルネーム
ざんにー	ザンニー	人名	
しゃこんぬ	シャコンヌ	人名	
かるてじあ	カルテジア	人名	
ふるーるどりす	フルールドリス	人名	
るぱ	ルパ	人名	
ふろーゔぁ	フローヴァ	人名	
ふろーば	フローヴァ	人名	
おーがすた	オーガスタ	人名	
ゆーの	ユーノ	人名	
がるぶれーな	ガルブレーナ	人名	
でびるはんたー	デビルハンター	人名	あだ名/ガルブレーナ
えんじぇる	エンジェル	人名	本名/ガルブレーナ
きゅうえん	仇遠	人名	
ちさ	千咲	名	
くちばちさ	朽葉千咲	人名	フルネーム/千咲
ぼくれい	卜霊	人名	
もーにえ	モーニエ	人名	
るしらー	ルシラー	人名	
しぐりか	シグリカ	人名	
りゅーくへるせん	リューク・ヘルセン	人名	
りんねー	リンネー	人名	
べーらたる	ベーラタル	人名	
ふぇんりこ	フェンリコ	人名	
ふぇんりこしゅざ	フェンリコ主座	人名	
こうもく	巧木	人名	
げんびょうしんじん	玄渺真人	人名	
まーけい	馬計	人名	
かじょりん	哥舒臨	人名	
しん	心	人名	
かじ	卦辞	人名	
とう	董	人名	
せんしん	繊晨	人名	
そうりえん	相里衍	人名	
まき	馬棋	人名	
くりすとふぉろ	クリストフォロ	人名	
あうぃでぃうす	アウィディウス	人名	
まるげりーた	マルゲリータ	人名	
そしきちょう	組織長	人名	
しゅゔぁるつろっほ	シュヴァルツロッホ	人名	
しゅばるつろっほ	シュヴァルツロッホ	人名	
かろーん	カローン	人名	
われんちな	ワレンチナ	人名	
ききょう	桔梗	人名	
くーもに	クーモニ	人名	
なみぽん	ナミポン	人名	
まき	真紀	人名	
すみか	澄夏	人名	
まるげりーた	マルゲリータ	人名	
おーろん	オーロン	人名	
とぅりお	トゥリオ	人名	
ろーずまりー	ローズマリー	人名	
ふるみーね	フルミーネ	人名	
しもす	シモス	人名	
みすたーしもす	ミスターシモス	人名	
ないあーら	ナイアーラ	人名	
なーらー	ナーラー	人名	
ゔぃゔぃあん	ヴィヴィアン	人名	
びびあん	ヴィヴィアン	人名	
べいきー	ベイキー	人名	
べいきー	「ベイキー」	人名	
らまぞってぃ	ラマゾッティ	人名	
ありーちぇ	アリーチェ	人名	
じゅの	ジュノ	人名	
ふるうぃあ	フルウィア	人名	
ぼいてぃあ	ボイティア	人名	
ゆりあ	ユリア	人名	
ゆりあしるゔぁ	ユリア・シルヴァ	人名	
ゆりあしるば	ユリア・シルヴァ	人名	
かとー	カトー	人名	
ねすとる	ネストル	人名	
ばぁりにあ	バァリニア	人名	
せりん	セリン	人名	
すーら	スーラ	人名	
すーら	「スーラ」	人名	
ぐらでぃえーたーのはゔぇる	グラディエーターのハヴェル	人名	
ぐらでぃえーたーのはべる	グラディエーターのハヴェル	人名	
ひたむきにこいしているさまんさ	ひたむきに恋しているサマンサ	人名	
かしこいにこらうす	賢いニコラウス	人名	
あどけないみーやちゃん	あどけないミーヤちゃん	人名	
りりべる	リリベル	人名	
てりす	テリス	人名	
のえみ	ノエミ	人名	
ひょうはくしゃ	漂泊者	人名	
ぎょしゃ	御者	人名	
ちょうりつしゃ	調律者	人名	
しちょう	師澄	人名	
かくい	郭囲	人名	
てんふう	天胡	人名	
こんれいいん	今令尹	人名	
まーしょうふぁん	馬小芳	人名	
おうへい	凹平	人名	
はなもち	花持	人名	
にわし	庭師	人名	
えだ	枝	人名	
あぶ	アブ	人名	
あぶらくさす	アブラクサス	人名	フルネーム/アブ
さいしゅ	歳主	人名	
かく	角	人名	
しん	心	人名	
いんぺらとる	インペラトル	人名	
しんげつこ	心月狐	人名	
めいしき	鳴式	人名	
むそうせんしゅ	無相燹主	人名	
れびやたん	レビヤタン	人名	
かげおい	影追	固有名詞	丹瑾/回避反撃スキル
しゅかざんしょう	朱華残章	固有名詞	丹瑾/共鳴スキル
せきか	赤華	固有名詞	丹瑾/単発スキル
しゅしょく	朱蝕	固有名詞	丹瑾/2段目派生スキル
しゅしょくのこくいん	朱蝕の刻印	固有名詞	丹瑾/スキルにより付与
じんめつ	燼滅	固有名詞	丹瑾/3段目派生スキル
こぼればな	零れ華	固有名詞	丹瑾/強化重撃
へきぎょくせきしん	碧玉赤心	固有名詞	丹瑾/共鳴回路
ひいろくるいざき	緋色狂咲	固有名詞	丹瑾/共鳴解放
かいめい	晦冥	固有名詞	丹瑾/終奏スキル
ひこう	緋光	固有名詞	丹瑾/固有スキル
まんいつ	満溢	固有名詞	丹瑾/固有スキル
とわいらいとぞーん	トワイライトゾーン	固有名詞	ザンニー/衣装
まちでのてぃーたいむ	町でのティータイム	固有名詞	ザンニー/スペシャル衣装
しんけんのけんのかげ	神権の剣の影	固有名詞	カルテジア/通常攻撃により召喚 (ティルフォング)
いけんのけんのかげ	異権の剣の影	固有名詞	カルテジア/重撃により召喚
じんけんのけんのかげ	人権の剣の影	固有名詞	カルテジア/共鳴スキルにより召喚
じんけんのしんずい	人権の心髄	固有名詞	カルテジア/人権の剣の影を回収
しんけんのいし	神権の意志	固有名詞	カルテジア/神権の剣の影を回収
いけんのかいりき	異権の怪力	固有名詞	カルテジア/異権の剣の影を回収
けんにてこのみをまつる	剣にてこの身を奉る	固有名詞	カルテジア/通常攻撃
ひとのこのためのけん	人の子のための剣	固有名詞	カルテジア/共鳴スキル
あれくるうしお	荒れ狂う潮	固有名詞	カルテジア/共鳴回路
けんにやどるはしおのこころ	剣に宿るは潮の心	固有名詞	カルテジア/フルールドリス共鳴スキル1段目
かぜさきなみくだくはじゃのいちげき	風裂き波砕く、破邪の一撃	固有名詞	カルテジア/フルールドリス共鳴スキル2段目
きしのたましいのさけびをきけ	騎士の魂の叫びを聴け	固有名詞	カルテジア/共鳴解放
あらぶるしおほえるかぜのやいば	荒ぶる潮、吼える風の刃	固有名詞	カルテジア/フルールドリス共鳴解放
すぎししおのためのけん	過ぎし潮のための剣	固有名詞	カルテジア/変奏スキル
かぜとしおのしゅくとうをきけ	風と潮の祝祷を聴け	固有名詞	カルテジア/終奏スキル
こころもておりなすいのり	心もて織りなす祈り	固有名詞	カルテジア/固有スキル
かぜもてきざむしんしょくのきずあと	風もて刻む侵食の痕	固有名詞	カルテジア/固有スキル
うんめいによりかんむりをいただく	運命により、冠を戴く	固有名詞	カルテジア/共鳴チェーン1
ふうちょうのりつどうをききあだなすやいばをくだく	風潮の律動を聴き、仇なす刃を砕く	固有名詞	カルテジア/共鳴チェーン2
わがみをばくしこうとうにかける	我が身を縛し、高塔に懸ける	固有名詞	カルテジア/共鳴チェーン3
きゅうさいのためにわがかたちをほろぼす	救済のために、己が形を滅ぼす	固有名詞	カルテジア/共鳴チェーン4
あらぶるかぜからきぼうをつくりだす	荒ぶる風から、希望を創り出す	固有名詞	カルテジア/共鳴チェーン5
ひとすじのひかりをもとめじゆうへかけだす	一筋の光を求め、自由へ駆け出す	固有名詞	カルテジア/共鳴チェーン6
いばらにふりそそぐあめ	茨に降り注ぐ雨	固有名詞	カルテジア/デフォルト衣装
もえあがるほし	燃え上がる星	固有名詞	ルパ/基本攻撃
じゅうげきかみつく	重撃・噛み付く	固有名詞	ルパ/重撃/狼の炎50pt
じゅうげきひきさく	重撃・引き裂く	固有名詞	ルパ/重撃/狼の炎50pt+狼の魂1
くうちゅうこうげきえんしょう	空中攻撃・炎衝	固有名詞	ルパ/空中攻撃/狼の炎50pt
つうじょうこうげきせいめつ	通常攻撃・星滅	固有名詞	ルパ/通常攻撃
まきがり	巻狩	固有名詞	ルパ/共鳴スキル
くらいつくす	喰らい尽くす	固有名詞	ルパ/共鳴スキル派生
きょうめいすきるくらいつくす	共鳴スキル・喰らい尽くす	固有名詞	ルパ/共鳴スキル派生
ほのおとよろこぶえいこう	炎と歓ぶ栄光	固有名詞	ルパ/共鳴解放
せめやぶる	攻め破る	固有名詞	ルパ/特殊状態
きょうめいすきるせめやぶる	共鳴スキル・攻め破る	固有名詞	ルパ/特殊状態
えんろうのせんこく	炎狼の宣告	固有名詞	ルパ/共鳴回路
もゆるはた	燃ゆる旗	固有名詞	ルパ/共鳴回路/バフ
ろうぶのけつい	狼舞の決意	固有名詞	ルパ/共鳴回路/狼の魂2pt
きょうめいすきるろうぶのけつい	共鳴スキル・狼舞の決意	固有名詞	ルパ/共鳴回路/狼の魂2pt
ろうぶのけついきわみ	狼舞の決意・極	固有名詞	ルパ/共鳴回路/狼の魂2ptかつマッチポイント
きょうめいすきるろうぶのけついきわみ	共鳴スキル・狼舞の決意・極	固有名詞	ルパ/共鳴回路/狼の魂2ptかつマッチポイント
しあいじょうをもえあがらせようぜ	試合場を燃え上がらせようぜ	固有名詞	ルパ/共鳴回路/狼舞の決意後
きょうめいすきるしあいじょうをもえあがらせようぜ	共鳴スキル・試合場を燃え上がらせようぜ	固有名詞	ルパ/共鳴回路/狼舞の決意後
どこみてるんだ	どこ見てるんだ？	固有名詞	ルパ/変奏スキル
どこみてるんだ	どこ見てるんだ?	固有名詞	ルパ/変奏スキル
あいぼうともにいこうぜ	相棒、共に行こうぜ	固有名詞	ルパ/終奏スキル
あたしのなをおぼえてろ	あたしの名を覚えてろ	固有名詞	ルパ/固有スキル
なもなきひとが	名もなき人が	固有名詞	ルパ/共鳴チェーン1
かりばをかけめぐり	狩場を駆け巡り	固有名詞	ルパ/共鳴チェーン2
おおかみはほのおでほうこうし	狼は炎で咆哮し	固有名詞	ルパ/共鳴チェーン3
はたはほのおでひるがえる	旗は炎で翻る	固有名詞	ルパ/共鳴チェーン4
しょうりがはくしゅかっさいをおくり	勝利が喝采拍手を贈り	固有名詞	ルパ/共鳴チェーン5
いちばんかがやかしいあのほのおのほしへ	一番輝かしいあの焔の星へ	固有名詞	ルパ/共鳴チェーン6
しょうりもあたしをたたえてるぜ	勝利もあたしを讃えてるぜ	固有名詞	ルパ/固有スキル
おおかみのほのお	狼の炎	固有名詞	ルパ/共鳴回路ゲージ
おおかみのたましい	狼の魂	固有名詞	ルパ/固有ゲージ
おうのせんい	王の戦意	固有名詞	オーガスタ/共鳴回路
おうのいこう	王の威光	固有名詞	オーガスタ/固有ゲージ
かりうどのけんぎ	狩人の剣技	固有名詞	オーガスタ/基本攻撃
ひらめくかみなり	閃く雷	固有名詞	オーガスタ/重撃・回避反撃/構成語句
きんてつならし	金鉄鳴らし	固有名詞	オーガスタ/重撃・回避反撃/構成語句
じゅうげきひらめくかみなりばっくすてっぷ	重撃・閃く雷・バックステップ	固有名詞	オーガスタ/重撃/王の戦意満タン時
じゅうげきひらめくかみなりかいてんぎり	重撃・閃く雷・回転斬り	固有名詞	オーガスタ/重撃/基本
じゅうげきひらめくかみなりばっくつきあげ	重撃・閃く雷・突き上げ	固有名詞	オーガスタ/重撃/王の戦意満タン時ジャンプ
かいひはんげきじゅうげききんてつならし	回避反撃・重撃・金鉄鳴らし	固有名詞	オーガスタ/回避反撃/王の戦意満タン時
かいひはんげきひらめくかみなりばっくすてっぷ	回避反撃・閃く雷・バックステップ	固有名詞	オーガスタ/重撃/王の威光満タン時
おれぬはがねのちかい	折れぬ鋼の誓い	固有名詞	オーガスタ/共鳴解放/一回押し
きょうめいかいほうおれぬはがねのちかい	共鳴解放・折れぬ鋼の誓い	固有名詞	オーガスタ/共鳴解放/1回押し
かくじつのくんりん	赫日の君臨	固有名詞	オーガスタ/共鳴解放/構成語句
きょうめいかいほうかくじつのくんりん	共鳴解放・赫日の君臨	固有名詞	オーガスタ/共鳴解放/威圧2スタック1回押し
かくじつのくんりんえんてん	赫日の君臨・炎天	固有名詞	オーガスタ/共鳴解放/強化状態時攻撃
かくじつのくんりんふめつのえいこんをやどすいっせん	赫日の君臨・不滅の英魂を宿す一閃	固有名詞	オーガスタ/共鳴解放/強化状態フィニッシュ
おうのれるむ	王のレルム	固有名詞	オーガスタ/共鳴解放/強化状態
むはいのえんよう	無敗の炎陽	固有名詞	オーガスタ/共鳴スキル/構成語句
むはいのえんようしゅんげき	無敗の炎陽・瞬撃	固有名詞	オーガスタ/共鳴スキル/通常
きょうめいすきるむはいのえんようしゅんげき	共鳴スキル・無敗の炎陽・瞬撃	固有名詞	オーガスタ/共鳴スキル/通常
むはいのえんようちょうげき	無敗の炎陽・跳撃	固有名詞	オーガスタ/共鳴スキル
きょうめいすきるむはいのえんようちょうげき	共鳴スキル・無敗の炎陽・跳撃	固有名詞	オーガスタ/共鳴スキル
むはいのえんようきゅうこうか	無敗の炎陽・急降下	固有名詞	オーガスタ/共鳴スキル/王の威光消費
きょうめいすきるむはいのえんようきゅうこうか	共鳴スキル・無敗の炎陽・急降下	固有名詞	オーガスタ/共鳴スキル/王の威光消費
かいひはんげきむはいのえんようしゅんげき	回避反撃・無敗の炎陽・瞬撃	固有名詞	オーガスタ/共鳴スキル/通常
けんほう	剣鋒	固有名詞	オーガスタ/共鳴スキル
きらめくせいと	煌めく征途	固有名詞	オーガスタ/共鳴解放
よこそたいようなり	余こそ太陽なり	固有名詞	オーガスタ/共鳴回路
やけるおうごんのしんぐん	灼ける黄金の進軍	固有名詞	オーガスタ/変奏スキル
ふくつのせんか	不屈の戦歌	固有名詞	オーガスタ/終奏スキル
ばんみんのねがいえいこうのかんむり	万民の願い・栄光の冠	固有名詞	オーガスタ/終奏スキル効果
えいこうのかご	栄光の加護	固有名詞	オーガスタ/固有スキル
もえたぎるけつい	燃え盛る決意	固有名詞	オーガスタ/固有スキル
やけのはらにそのみはさじんにまみれる	焼け野原に、その身は砂塵に塗れる	固有名詞	オーガスタ/共鳴チェーン1
さつりくのちけむりにそのたましいはきよめられる	殺戮の血煙に、その魂は浄められる	固有名詞	オーガスタ/共鳴チェーン2
くちゆくせかいにそのしんはとぎあげられる	朽ちゆく世界に、その芯は研ぎ上げられる	固有名詞	オーガスタ/共鳴チェーン3
えいこうのただなかにそのみちはこどくにさだめられる	栄光の只中に、その道は孤独に定められる	固有名詞	オーガスタ/共鳴チェーン4
あらぶるしおにそのすがたはゆるがず	荒ぶる潮に、その姿は揺るがず	固有名詞	オーガスタ/共鳴チェーン5
まばゆいひかりにそのなはえいえんにきざまれる	まばゆい光に、その名は永遠に刻まれる	固有名詞	共鳴チェーン6
げっそうのめぐり	月相の巡り	固有名詞	ユーノ/強化状態トリガー
げっそうのめぐりみかづき	月相の巡り・三日月	固有名詞	ユーノ/強化状態
げっそうのめぐりげんげつ	月相の巡り・弦月	固有名詞	ユーノ/強化状態
よげんするもののここう	予言する者の孤行	固有名詞	ユーノ/基本攻撃
つきのわ	月の環	固有名詞	ユーノ/基本攻撃/構成語句
つきのゆみ	月の弓	固有名詞	ユーノ/基本攻撃/構成語句
つきのわつうじょうこうげき	月の環・通常攻撃	固有名詞	ユーノ/基本攻撃/基本
つきのわかいひはんげき	月の環・回避反撃	固有名詞	ユーノ/回避反撃
つきのゆみつうじょうこうげき	月の弓・通常攻撃	固有名詞	ユーノ/基本攻撃/月相の巡り・三日月状態
つきのゆみかいひはんげき	月の弓・回避反撃	固有名詞	ユーノ/回避反撃/月相の巡り・三日月状態
よけんのみちびき	予見の導き	固有名詞	ユーノ/共鳴スキル
げんしょのりつどう	原初の律動	固有名詞	ユーノ/共鳴スキル・基本
しゅうまつのひびき	終末の響き	固有名詞	ユーノ/共鳴スキル・通常
みかんのひびき	未完の響き	固有名詞	ユーノ/共鳴スキル・弦月
げんかいをこえるひとひき	限界を超える一引き	固有名詞	ユーノ/共鳴スキル・三日月
おぼれしつきのうみ	溺れし月の海	固有名詞	ユーノ/共鳴解放
みちかけのあいだにゆらぐ	満ち欠けの間に揺らぐ	固有名詞	ユーノ/共鳴回路
じゅうげきしこうのえんまん	重撃・至高の円満	固有名詞	ユーノ/強化重撃
しこうのえんまん	至高の円満	固有名詞	ユーノ/強化重撃
まんげつりょういき	満月領域	固有名詞	ユーノ/共鳴回路
そうはくなるしこうのしゅくじ	蒼白なる死光の祝詞	固有名詞	ユーノ/共鳴回路
そうはくなるしこうののりと	蒼白なる死光の祝詞	固有名詞	ユーノ/共鳴回路
れいせい	霊性	固有名詞	ユーノ/共鳴回路
わたしがてらしあらわす	私が照らし顕す	固有名詞	ユーノ/変奏スキル
よるをわたりてあかつきへ	夜を渡りて暁へ	固有名詞	ユーノ/終奏スキル
えいしょう	盈昇	固有名詞	ユーノ/固有スキル
しんえん	新衍	固有名詞	ユーノ/固有スキル
まんげつもみかづきもきんのえだをいろどるために	満月も三日月も、金の枝を彩るために	固有名詞	ユーノ/共鳴チェーン1
ひるもよるもすがたかわらず	昼も夜も、姿変わらず	固有名詞	ユーノ/共鳴チェーン2
ぼうきゃくくみてつくす	忘却を酌みて尽くす	固有名詞	ユーノ/共鳴チェーン3
ひとみにやどりしあめのきせつ	瞳に宿りし雨の季節	固有名詞	ユーノ/共鳴チェーン4
いくたのうしろをみさだめ	幾多の虚ろを見定め	固有名詞	ユーノ/共鳴チェーン5
わたしのそんざいこそゆいいつのふへん	私の存在こそ、唯一の不変	固有名詞	ユーノ/共鳴チェーン6
まえん	魔炎	固有名詞	ガルブレーナ/共鳴ゲージ
よえん	余炎	固有名詞	ガルブレーナ/共鳴ゲージ
じょうかのほのお	浄化の炎	固有名詞	ガルブレーナ/共鳴ゲージ
あかりにかざすけんぶ	灯りにかざす剣舞	固有名詞	仇遠/共鳴ゲージ
こくちゅうのあお	黒中の蒼	固有名詞	仇遠/通常攻撃
おうけんこくちゅうのあお	応剣・黒中の蒼	固有名詞	仇遠/強化通常攻撃
おうけんでんしょうのおんりつ	応剣・伝承の音律	固有名詞	仇遠/強化重撃
おうけんけんしんのけつい	応剣・献身の決意	固有名詞	仇遠/強化重撃派生
おんけんふへんのちゅうせつ	応剣・不変の忠節	固有名詞	仇遠/強化重撃派生
こころはじゅうようなり	心は従容なり	固有名詞	仇遠/固有スキル
ばんこのうれいをともにはらさん	万古の愁を共に晴らさん	固有名詞	仇遠/固有スキル
すいぼくりんり	酔墨淋漓	固有名詞	仇遠/強化状態
せんりをもじせず	千里をも辞せず	固有名詞	仇遠/共鳴スキル(長押し)
ふどうのけんばんしょうをおこすこころ	不動の剣、万象を起こす心	固有名詞	仇遠/共鳴チェーン1
けんよそれがしをでんしょうのおんりつをたちきったものというか	剣よ、某を伝承の音律を断ち切った者と謂うか	固有名詞	仇遠/共鳴チェーン2
けんよそれがしをけんしんのけついをふみにじったものというか	剣よ、某を献身の決意を踏み躙った者と謂うか	固有名詞	仇遠/共鳴チェーン3
けんよそれがしをふへんのちゅうせつをきりきざんだものというか	剣よ、某を不変の忠節を斬り刻んだ者と謂うか	固有名詞	仇遠/共鳴チェーン4
けんよいまそれがしはたからかにうたおう	剣よ、今は某と高らかに歌おう	固有名詞	仇遠/共鳴チェーン5
おのれをなすけいちょうしんしょうことば	己を成す傾聴、心象、言葉	固有名詞	仇遠/共鳴チェーン6
ぜったいてきむおん	絶対的無音	固有名詞	千咲/基本攻撃
はさいをみちびくつき	破砕を導く突き	固有名詞	千咲/通常攻撃3段目(派生)
いのちかりのはさみ	命刈りのハサミ	固有名詞	千咲/通常攻撃4段目(派生)
とりのぞかれるげん	取り除かれる弦	固有名詞	千咲/通常攻撃5段目(派生)
くずれおちるしゅうえん	崩れ落ちる終焉	固有名詞	千咲/空中攻撃(派生)
かいひはんげきかいげんのめいんげん	回避反撃・解弦の眼・引弦	固有名詞	千咲/特殊回避反撃
じゅうげきさいおんのせつだんめん	重撃・砕音の切断面	固有名詞	千咲/重撃2段目(派生)
くだけたこうず	砕けた構図	固有名詞	千咲/共鳴スキル
かいげんのめ	解弦の眼	固有名詞	千咲/共鳴スキル
まわるはぐるま	廻る歯車	固有名詞	千咲/強化共鳴スキル
そっこくきょむかいき	即刻・虚無回帰	固有名詞	千咲/共鳴解放
そっこくこむかいき	即刻・虚無回帰	固有名詞	千咲/共鳴解放
よろずのいとついへのしゅうそく	万の糸・終への収束	固有名詞	千咲/強化状態
かいげんのしかいかいたいされるばんぶつ	解弦の視界・解体される万物	固有名詞	千咲/共鳴回路
きょむのしめあと	虚無の絞め痕	固有名詞	千咲/共鳴回路(付与)
こむのしめあと	虚無の絞め痕	固有名詞	千咲/共鳴回路(付与)
うつろなるせん	虚ろなる線	固有名詞	千咲/共鳴回路(防御無視)
ちぇんそーもーど	チェンソーモード	固有名詞	千咲/状態
ちぇーんそーもーど	チェンソーモード	固有名詞	千咲/状態
きりさきそっこう	切り裂き・速攻	固有名詞	千咲/通常攻撃(チェンソーモード)
ちぇんそーもーどかいひはんげき	チェンソーモード・回避反撃	固有名詞	千咲/回避反撃(チェンソーモード)
きりさきしゅうけつ	切り裂き・終結	固有名詞	千咲/フィニッシュ攻撃(チェンソーモード)
いのちのげんほんりゅう	命の弦・本流	固有名詞	千咲/共鳴ゲージ
いのちのげんよぎるきせき	命の弦・よぎる軌跡	固有名詞	千咲/特殊回避
ちぇんそーひーと	チェンソーヒート	固有名詞	千咲/共鳴ゲージ
きりさきのざんきょう	切り裂きの残響	固有名詞	千咲/固有ポイント
なりひびきふたたび	鳴り響き・再び	固有名詞	千咲/変奏スキル
かいげんしきほうそくぜろ	解弦式法則・ゼロ	固有名詞	千咲/終奏スキル
でぐちのないうんめい	出口のない運命	固有名詞	千咲/固有スキル
ここがしゅうえんです	ここが終焉です	固有名詞	千咲/固有スキル
すたれたかいろうをわたって	廃れた回廊を渡って	固有名詞	千咲/共鳴チェーン1
きずなをおりなすうんめいのいと	絆を織りなす運命の糸	固有名詞	千咲/共鳴チェーン2
さまよったよるそのさきへ	彷徨った夜、その先へ	固有名詞	千咲/共鳴チェーン3
とざされたるーぷをたちきる	閉ざされたループを断ち切る	固有名詞	千咲/共鳴チェーン4
かえりみちをてらすいくまんのともしび	帰り道を照らす幾万の灯火	固有名詞	千咲/共鳴チェーン5
うしなわれたきぼうとひかりをいまここに	失われた希望と光を、今ここに	固有名詞	千咲/共鳴チェーン6
これまでのあゆみ	これまでの歩み	固有名詞	千咲/衣装
