めいちょう	鳴潮	固有名詞	
めいちょう	Wuthering Waves	固有名詞	
わざうぇいぶ	Wuthering Waves	固有名詞	
ひょうはくしゃ	漂泊者	人名	
ひめい	悲鳴	名詞	
はんきょう	反響	名詞	
そうせいちょう	走声蝶	名詞	
かいゆうぎょ	回遊魚	名詞	
おんがい	音骸	名詞	
そのら	音場	名詞	
かいしょくげんしょう	海蝕現象	名詞	
むおんく	無音区	名詞	
ざんぞうちょう	残像潮	名詞	
くろいし	黒石	名詞	
てんくうかい	天空海	名詞	
そかいあめ	溯洄雨	名詞	
かそ	華胥	固有名詞	
はんきょうぐも	反響雲	名詞	
くろしお	黒潮	名詞	
うんかい	雲海	名詞	
いんかいきょうだん	隠海教団	組織	
すいふうきゅう	水風級	名詞	
きょろうきゅう	巨浪級	名詞	
どとうきゅう	怒涛級	名詞	
つなみきゅう	津波級	名詞	
めいしき	鳴式	固有名詞	
むそうせんしゅ	無相燹主	人名	
うんりょうだに	雲陵谷	名詞	
わんとう	湾刀	名詞	
ほくらくのはら	北落野原	地名	
おんこう	音匣	名詞	
きょうめいしゃ	共鳴者	名詞	
でばいす	瓢箪	固有名詞	
おんこん	音痕	名詞	
おーばーくろっく	自滅	名詞	
そりゅうき	遡流器	名詞	
しょくてい	稷廷	地名	
くろいしぶき	黒石武器	名詞	
ちょうじん	長刃	名詞	
じんとう	迅刀	名詞	
けんじゅう	拳銃	名詞	
てっこう	手甲	名詞	
ぞうふくき	増幅器	名詞	
ふらくとしです	残星組織	組織	
ぎょしゃ	御者	人名	
ぶらっくしょあ	黒海岸	組織	
ぶらっくしょあ	ブラックショア	組織	
らっこうむら	落香村	地名	
ちょうりつしゃ	調律者	人名	
しんい	辛夷	名詞	
ごひいきさま	御贔屓様	名詞	
しちょう	師澄	人名	
さいしゅ	歳主	人名	
かく	角	人名	
かくしゅく	角宿	地名	
こうしゅく	亢宿	地名	
ていしゅく	氐宿	地名	
ぼうしゅく	房宿	地名	
しんしゅく	心宿	地名	
びしゅく	尾宿	地名	
きしゅく	箕宿	地名	
りゅうみんてい	龍眠庭	地名	
しんごうとう	信号塔	名詞	
はんこ	盤古	名詞	
こうりゅう	瑝瓏	地名	
いっていろくしゅう	一庭六州	地名	
しょうしゅう	詔州	地名	
えっしゅう	越州	地名	
こうと	瑝都	地名	
むしゅう	夢州	地名	
こんしゅう	今州	地名	
せっししょ	折子書	名詞	
いっていごしゅう	一庭五州	地名	
こんしゅうじょう	今州城	地名	
へんてい	辺庭	地名	
こうらんるいしょ	瑝覧類書	固有名詞	
れいいん	令尹	固有名詞	
じょうしょうさん	乗霄山	地名	
こうちん	虹鎮	地名	
れいさのいずみ	霊砂の泉	地名	
すいえいへい	水影塀	名詞	
よき	夜帰	組織	
はじん	破陣	組織	
ふくは	伏波	組織	
とうはく	踏白	組織	
じゅんねいじょ	巡寧所	組織	
かくい	郭囲	人名	
てんこうへんきょうぼうえい	天工辺境防衛	固有名詞	
ずいしだん	瑞獅団	固有名詞	
こうりゅうだん	絞龍団	固有名詞	
てんふう	天胡	人名	
こんれいいん	今令尹	人名	
かく	角	人名	
しんげつこ	心月狐	固有名詞	
まーしょうふぁん	馬小芳	人名	
けいとかい	競渡会	固有名詞	
げっついさい	月追祭	固有名詞	
しゅんりゅうさい	春龍祭	固有名詞	
おうへい	凹平	人名	
いしょういてんじょ	異象移転所	組織	
はなもち	花持	人名	
にわし	庭師	人名	
えだ	枝	人名	
うんかいれっしゃ	雲海列車	固有名詞	
きゅうしんがっこう	旧神学校	組織	
ねぷてゅーにあ	海淵の星	地名	
むごうりょうほう	霧合療法	固有名詞	
むごうやくざい	霧合薬剤	固有名詞	
しゅざ	主座	名詞	
ないしゃいん	内赦院	組織	
かいりついん	戒律院	組織	
ざんげいん	懺悔院	組織	
しんけん	神権	名詞	
いけん	異権	名詞	
かんこんさい	還魂祭	固有名詞	
せんくじょうやく	先駆条約	組織	
せんくらじお	先駆ラジオ	固有名詞	
よしゅう	予洲	地名	
そりゅうき	溯流器	名詞	
しゃだんこうまく	遮断光幕	名詞	
ごーすとはうんど	幽霊猟犬	組織	
ぎゃっきょうしんとう	逆境深塔	固有名詞	
ざんきょうのとう	残響の塔	固有名詞	
はんきょうのとう	反響の塔	固有名詞	
しんきょうのとう	深境の塔	固有名詞	
あんていえりあ	安定エリア	固有名詞	
じっけんえりあ	実験エリア	固有名詞	
きんいきえりあ	禁域エリア	固有名詞	
ほろたくてぃくす	ホロタクティクス	固有名詞	
しのうみがまとううみのはいきょ	死の歌が纏う海の廃墟	固有名詞	
はいきょ	死の歌が纏う海の廃墟	固有名詞	
きんきのかいいき	禁忌の海域	固有名詞	
さいせいのかいいき	再生の海域	固有名詞	
さいせいのかいいききゃずむ	再生の海域・キャズム	固有名詞	
きゃずむ	再生の海域・キャズム	固有名詞	
さいせいのかいいきあびす	再生の海域・アビス	固有名詞	
あびす	再生の海域・キャズム	固有名詞	
えんどれすあびす	エンドレス・アビス	固有名詞	
きょうめいすきる	共鳴スキル	名詞	
きょうめいかいほう	共鳴解放	名詞	
きょうめいえねるぎー	共鳴エネルギー	名詞	
きょうめいかいろ	共鳴回路	名詞	
しゅうそう	終奏	名詞	
へんそう	変奏	名詞	
しゅうそうすきる	終奏スキル	名詞	
へんそうすきる	変奏スキル	名詞	
きょうそうえねるぎー	協奏エネルギー	名詞	
きょうどうこうげき	共同攻撃	名詞	
いじょうこうか	異常効果	名詞	
けっそう	結霜	名詞	
けっそうこうか	結霜効果	名詞	
さいばく	斉爆	名詞	
さいばくこうか	斉爆効果	名詞	
でんじこうか	電磁効果	名詞	
ふうしょく	風蝕	名詞	
ふうしょくこうか	風蝕効果	名詞	
そうこう	騒光	名詞	
そうこうこうか	騒光効果	名詞	
きょめつ	虚滅	名詞	
きょめつこうか	虚滅効果	名詞	
せいせい	星声	名詞	
げっそう	月相	名詞	
しぇるこいん	シェルコイン	名詞	
けっしょうはちょうばん	結晶波長板	名詞	
けっしょうはちょうせいれんばん	結晶波長精錬板	名詞	
しょうかんのなみもよう	唱喚の渦模様	名詞	
きんずいのなみもよう	金髄の波模様	名詞	
たんちょうのなみもよう	鍛潮の波模様	名詞	
よはさんご	余波珊瑚	名詞	
ざんしんさんご	残振珊瑚	名詞	
ひぞうたんちき	秘蔵探知機	名詞	
たんおんそなー	探音ソナー	名詞	
かいしょくきめら	海蝕キメラ	名詞	
ちんたいきんぞくどろっぷ	沈滞金属ドロップ	名詞	
かっせいきんぞくぶろっぷ	活性金属ドロップ	名詞	
きょくかきんぞくどろっぷ	極化金属ドロップ	名詞	
いたいきんぞくどろっぷ	異体金属ドロップ	名詞	
きんぞくどろっぷ	金属ドロップ	名詞	
ふじゅんけっしょうねんそ	不純結晶燃素	名詞	
そひんけっしょうねんそ	粗品結晶燃素	名詞	
せいれんけっしょうねんそ	精錬結晶燃素	名詞	
じゅんすいけっしょうねんそ	純粋結晶燃素	名詞	
けっしょうねんそ	結晶燃素	名詞	
せいりつのたね	声律の種	名詞	
せいりつのなえ	声律の苗	名詞	
せいりつのは	声律の葉	名詞	
せいりつのつぼみ	声律の蕾	名詞	
せいりつ	声律	名詞	
ぷれすとらせん	プレスト螺旋	名詞	
あんだんてらせん	アンダンテ螺旋	名詞	
あだーじょらせん	アダージョ螺旋	名詞	
れんとらせん	レント螺旋	名詞	
うなりおんかく	唸り音核	名詞	
さけびおんかく	叫び音核	名詞	
らせんおんかく	螺旋音核	名詞	
しんしょくせいる	侵食セイル	名詞	
あやめ	鳶尾花	名詞	
ちゆうきんれん	黒野荒蓮	名詞	
ぶどうほおずき	灯籠菓	名詞	
おおごちょう	金陽鳳	名詞	
ぐびじん	妙姿花	名詞	
かわらたけ	雲芝	名詞	
やぐるまぎく	傲寒鐘	名詞	
むらさきさんご	紫珊瑚	名詞	
げんぺいくさぎ	ゲンペイクサギ	名詞	
えんじゃくか	燕雀菓	名詞	
かくせい	客星	名詞	
そーどあこーらす	ソードアコーラス	名詞	
ごーるでんふりーす	ゴールデンフリース	名詞	
すぱーくじゅえるうーど	スパークジュエルウード	名詞	
しぇんどれりす	ツェンドレリス	名詞	
ばんぶーあいりす	バンブー・アイリス	名詞	
びばーなむてぃぬす	ビバーナムティヌス	名詞	
はんきょうのしゅはたい	反響の周波帯	名詞	
めいしょうのかめ	鳴鐘の亀	人名	
すかー	スカー	人名	
むぼうしゃ	無妄者	人名	
へかてー	ヘカテー	人名	
らいせつのうろこ	雷刹のウロコ	人名	
りょうげんのえんき	燎原の炎騎	人名	
むじょうのさぎ	無情のサギ	人名	
かがやきほたるのぐんぜい	輝き蛍の軍勢	人名	
ひれんのおおざる	飛廉の大猿	人名	
あいせつのきょうちょう	哀切の凶鳥	人名	
むかんしゃ	無冠者	人名	
きかいあぼみねーしょん	機械アボミネーション	人名	
うんせんのうろこ	雲閃のウロコ	人名	
ふぇいたるえらー	フェイタルエラー	人名	
ろーれらい	ローレライ	人名	
ぜのころっさす	ゼノコロッサス	人名	
なげきどれいく	嘆きのドレイク	人名	
ふるーるどりす	響き渡る共鳴・フルールドリス	人名	
ひびきわたるきょうめいふるーるどりす	響き渡る共鳴・フルールドリス	人名	
ほまれのらいおねす	誉れのライオネス	人名	
けるぴー	ケルピー	人名	
たんきん	丹瑾	人名	
たおき	桃祈	人名	
やんやん	秧秧	人名	
かんしん	鑑心	人名	
えんぶ	淵武	人名	
しか	熾霞	人名	
びゃくし	白芷	人名	
さんか	散華	人名	
りんよう	凌陽	人名	
きえん	忌炎	人名	
いんりん	吟霖	人名	
こんし	今汐	人名	
ちょうり	長離	人名	
おりえ	折枝	人名	
そうりよう	相里要	人名	
そゆご	釉瑚	人名	
とうとう	灯灯	人名	
ゔぇりーな	ヴェリーナ	人名	
べりーな	ヴェリーナ	人名	
あーると	アールト	人名	
かかろ	カカロ	人名	
もるとふぃー	モルトフィー	人名	
あんこ	アンコ	人名	
しょあきーぱー	ショアキーパー	人名	
つばき	ツバキ	人名	
かるろった	カルロッタ	人名	
ろここ	ロココ	人名	
ふぃーびー	フィービー	人名	
ぶらんと	ブラント	人名	
かんたれら	カンタレラ	人名	
ざんにー	ザンニー	人名	
しゃこんぬ	シャコンヌ	人名	
かるてじあ	カルテジア	人名	
ふるーるどりす	フルールドリス	人名	
るぱ	ルパ	人名	
ふろーゔぁ	フローヴァ	人名	
ふろーば	フローヴァ	人名	
ゆーの	ユーノ	人名	
おーがすた	オーガスタ	人名	
べーらたる	ベーラタル	人名	
ふぇんりこ	フェンリコ	人名	
ふぇんりこしゅざ	フェンリコ主座	人名	
こうもく	巧木	人名	
げんびょうしんじん	玄渺真人	人名	
まーけい	馬計	人名	
かじょりん	哥舒臨	人名	
しん	心	人名	
かじ	卦辞	人名	
とう	董	人名	
せんしん	繊晨	人名	
そうりえん	相里衍	人名	
まき	馬棋	人名	
くりすとふぉろ	クリストフォロ	人名	
かげおい	影追	固有名詞	丹瑾/回避反撃スキル
しゅかざんしょう	朱華残章	固有名詞	丹瑾/共鳴スキル
せきか	赤華	固有名詞	丹瑾/単発スキル
しゅしょく	朱蝕	固有名詞	丹瑾/2段目派生スキル
しゅしょくのこくいん	朱蝕の刻印	固有名詞	丹瑾/スキルにより付与
じんめつ	燼滅	固有名詞	丹瑾/3段目派生スキル
こぼればな	零れ華	固有名詞	丹瑾/強化重撃
へきぎょくせきしん	碧玉赤心	固有名詞	丹瑾/共鳴回路
ひいろくるいざき	緋色狂咲	固有名詞	丹瑾/共鳴解放
かいめい	晦冥	固有名詞	丹瑾/終奏スキル
ひこう	緋光	固有名詞	丹瑾/固有スキル
まんいつ	満溢	固有名詞	丹瑾/固有スキル
しんけんのけんのかげ	神権の剣の影	固有名詞	カルテジア/通常攻撃により召喚
いけんのけんのかげ	異権の剣の影	固有名詞	カルテジア/重撃により召喚
じんけんのけんのかげ	人権の剣の影	固有名詞	カルテジア/共鳴スキルにより召喚
じんけんのしんずい	人権の心髄	固有名詞	カルテジア/人権の剣の影を回収
しんけんのいし	神権の意志	固有名詞	カルテジア/神権の剣の影を回収
いけんのかいりき	異権の怪力	固有名詞	カルテジア/異権の剣の影を回収
けんにてこのみをまつる	剣にてこの身を奉る	固有名詞	カルテジア/通常攻撃
ひとのこのためのけん	人の子のための剣	固有名詞	カルテジア/共鳴スキル
あれくるうしお	荒れ狂う潮	固有名詞	カルテジア/共鳴回路
きしのたましいのさけびをきけ	騎士の魂の叫びを聴け	固有名詞	カルテジア/共鳴解放
あらぶるしおほえるかぜのやいば	荒ぶる潮、吼える風の刃	固有名詞	カルテジア/共鳴解放2段目
すぎししおのためのけん	過ぎし潮のための剣	固有名詞	カルテジア/変奏スキル
かぜとしおのしゅくとうをきけ	風と潮の祝祷を聴け	固有名詞	カルテジア/終奏スキル
こころもておりなすいのり	心もて織りなす祈り	固有名詞	カルテジア/固有スキル
かぜもてきざむしんしょくのきずあと	風もて刻む侵食の痕	固有名詞	カルテジア/固有スキル
うんめいによりかんむりをいただく	運命により、冠を戴く	固有名詞	カルテジア/共鳴チェーン1
ふうちょうのりつどうをききあだなすやいばをくだく	風潮の律動を聴き、仇なす刃を砕く	固有名詞	カルテジア/共鳴チェーン2
わがみをばくしこうとうにかける	我が身を縛し、高塔に懸ける	固有名詞	カルテジア/共鳴チェーン3
きゅうさいのためにわがかたちをほろぼす	救済のために、己が形を滅ぼす	固有名詞	カルテジア/共鳴チェーン4
あらぶるかぜからきぼうをつくりだす	荒ぶる風から、希望を創り出す	固有名詞	カルテジア/共鳴チェーン5
ひとすじのひかりをもとめじゆうへかけだす	一筋の光を求め、自由へ駆け出す	固有名詞	カルテジア/共鳴チェーン6
いばらにふりそそぐあめ	茨に降り注ぐ雨	固有名詞	カルテジア/デフォルト衣装
