いし	唱喚の渦模様	名詞	
いし	金髄の波模様	名詞	
いし	鍛潮の波模様	名詞	
いし	星声	名詞	
むりょういし	星声	名詞	
むしょういし	星声	名詞	
いし	月相	名詞	
ゆうりょういし	月相	名詞	
ゆうしょういし	月相	名詞	
すたみな	結晶波長板	名詞	
すたみな	結晶波長精錬板	名詞	
おかね	シェルコイン	名詞	
たからばこ	秘蔵箱	名詞	
たからばこ	潮汐の贈物	名詞	
すきる	共鳴スキル	名詞	
うると	共鳴解放	名詞	
ちゃーじ	共鳴エネルギー	名詞	
わーぷぽいんと	信号塔	名詞	
ふぁすととらべる	信号塔	名詞	
しゅじんこう	漂泊者	名詞	
こうたい	変奏	名詞	
きゃらくたーちぇんじ	変奏	名詞	
きゃらへん	変奏	名詞	
てき	残像	名詞	
もんすたー	残像	名詞	
とつ	共鳴チェーン	名詞	
